空空空空空空空空空空空空空
空砖空空砖空空砖空空砖空空
空砖空空砖空空砖空空砖空空
空砖空空砖空空砖空空砖空空
空砖空空砖空空砖空空砖空空
空草草空草草空草空草草空空
空砖空空砖空空砖空空空空空
空砖空空砖空空空空空空空空
空铁空铁铁铁空空铁铁空空空
空砖空空空空空空空空空空空
空砖水空空水空水空水空水空
空砖空空空空空空空空空空空
空空空空空空空空空空空空空